       WWWWWWW   WWW
       W.....W   WDW
WWWWWWWW.WWW.WWWWW.W
WS.......W W...B...W
WWWWWWWWWW WWWWWWWWW
