WWWWWWWWWWWWWWWWWWW
WDW..........WWWWWW
W.....WWW........WW
WWWW..W.W....WWW.WW
W............WWW.WW
W.W..........W...WW
W.WWW........W.WWWW
WLWS.........W....W
W.WWW.....B..WWWW.W
W.W.B....W.W.WWW..W
WB.BBW...W...WWW.WW
W.W.WW...W....WW..W
W..B.W...W...BBKW.W
W....WWWWW..WWWWWDW
WWWWWWWWWWWWWWWWWWW
