WWWWW      WWWWW
W...WWWWWWWW...W
W.W.WW....WW.W.W
W..............W
WW.WWWW..WWWW.WW
 W.W W....W W.W
 WSW W....W WDW
 WWW WWWWWW WWW