            WWW
            WSW
   WWWWWWWWWW.WWW
WWWW............W
WD..............W
WWW.............W
  WWWWWWWWWWWWWWW