       WWWWWWW   WWW
       W.....W   WDW
WWWWWWWW.WWW.WWWWW.W
WS.......W W...Y...W
WWWWWWWWWW WWWWWWWWW
