WWW        WWW
WDW        WSW
W.W    WWWWW.W
WLWWWWWW..WW.W
W............W
W..WWK.WWWW..W
WWWWWWWWWWWWWW