WWW        WWW
WDW        WSW
W.W    WWWWW.W
W.WWWWWW..WW.W
W............W
W..WW..WWWW..W
WWWWWWWWWWWWWW