WWWWWWWWWWWWWWWWWWW
W........WBBWBB...W
W.W.......BBBB.W..W
W...W.....BBBB.WLWW
W.........BBBB.W.DW
W.....BBBCB....WWWW
W.....B.BBB.......W
W.....B...........W
WWBBB.......B.....W
WKBBBB............W
W..W..........WW..W
W.............WWWWW
W.W.WSW.W.........W
W...WWW...........W
WWWWWWWWWWWWWWWWWWW
