            WWW
     WWWWW  WDW
  WWWW...WWWW.WWW
WWW.........W...W
WS..........W...W
WWWW...W........W
   WWWWWWWWWWWWWW