            WWW
            WSW
   WWWWWWWWWW.WWW
WWWW............W
WD......C.......W
WWW.............W
  WWWWWWWWWWWWWWW
