WWWWWW   WWWW
W....W   W..WWW
W....WWW W....W
WW....CWWW....WW
 W....B..W...B.WW
WW.WW..W.WW...B.W
W..WW...B......WWW
W...W..B........KW
W...W.W.WWW.W....W
WW..W..B..WB...WWW
WW.WWWWWW.W...B.W
 W.WWWWS..W..B.WW
 W.L.DW...W...WW
 W.WWWW...WW..W
 WWW  WWWWWWWWW
