WWWWWWWWWWWWWWW
W.............W
W.WWWWWWWWWWW.WWWW
W.WWWD.......B...W
W.WWWWWWWWWWW.WW.W
W.WWWWWWWWWWWSWW.W
W.WWWWWWWWWWWWWW.W
W.WWWW..WWC...WW.W
W................W
WWWWW......WWWWWWW
