      WWWW WWWWWW
      W..WWW..WSW
      W.B...B.W.W
     WWW.WWW.WW.W
WWWWWW..BWWW...BW
W..WWW.WBW.W.WW.WW
W.B...B.B.BWB..B.W
W.B....W.WCW.WW.WW
W.BBWBB.B.B.B.W.WWW
W.BBWW..B.B.B.WWWLW
W.BBWW..WW.W..WD..W
W.BB.WWWWWWWWWWWWWW
W...KW
WWWWWW
