WWWWWWWWWWWWWWWWWWW
W.....WW.W...WKW..W
W.....W....W.WB...W
W.....W..WWWB...W.W
W.WWW.W..W.B.W..W.W
W.WDW.WC.WW.B.B.W.W
WB....W..W.B...WW.W
WLWWWWW..WW.B.WW..W
W.W......W..BWW.B.W
W.W......W...WW...W
W.WWWW...WWWWWWWW.W
W..W...........SW.W
W...........WWWWW.W
W.................W
WWWWWWWWWWWWWWWWWWW
