       WWWWWWW   WWW
       W.....W   WDW
WWWWWWWW.WWW.WWWWW.W
WS..C....W W...B...W
WWWWWWWWWW WWWWWWWWW