
WWWWWWWWWWWWWWWWWWW
WDW..........W.C.CW
W.....WWW....WC.C.W
WWWW..W.W......C.CW
W............WC.C.W
W.W..........W.C.CW
W.WWW........WC.C.W
WLW..........W.C.CW
W.WWW.....B..WC.C.W
W.W.B....W.W.W.C.CW
WB.BBW...W...WW...W
W.W.WW...W....WWW.W
W..B.W...W...BBKW.W
W....WWWWW..WWWWWSW
WWWWWWWWWWWWWWWWWWW
