WWWWW   WWWWW
W.W.WWSWW.W.W
W..B..B..B..WWWW
WWW.WW.WW.WWWWDW
 WW.WW.WW.WWWW.WW
 W....B..B..WW..W
 WC..W.WW.W.W...W
 W.....WW...W.WWW
 W.WWWWWWWWWW...W
 W..............W
 WWWWWWWWWWWWWWWW
