WWWWWWWWWWWWWWWWWWW
WK......WBBWBB....W
W.W.......BBBB.W..W
W...W.....BBBB.WLWW
W.........BBBB.W.DW
W.....BBBCB....WWWW
W.....B.BBB.......W
W.....B...........W
WWBBBY......B.....W
WFBBBB............W
W..W.B........WW..W
W.............WWWWW
W.W.WSW.W.........W
W...WWW...........W
WWWWWWWWWWWWWWWWWWW
