WWWWWWWWWWWWWWWWWWW
W-W----------W.C.CW
W-----WWW----WC.C.W
WWWW--W-W----..C.CW
W------------WC.C.W
W-W----------W.C.CW
W-WWW--------WC.C.W
WLW----------W.C.CW
W-WWW--------WC.C.W
W-W------W-W-W.C.CW
W----W---W---WW...W
W-W-WW---W----WWW.W
W----W---W------W.W
W----WWWWW--WWWWW.W
WWWWWWWWWWWWWWWWWWW
