WWW        WWW
WDW        WSW
W.W    WWWWW.W
W.WWWWWW..WW.W
W............W
W..WWF.WWWW..W
WWWWWWWWWWWWWW
