 WWWWWWWWWWWWWWWW
WW..............W
W..WWWWBB....B..W
W...BC.......B..W
WWW.BWWW.WWWW.WWW
  W.BWWWDW..W.W
WWW.BWWWWW..W.W
W.....WWWW..WSW
W.WWW.......WWW
W.WWW.....W.W
W.....WWW...W
WWWWWWW WWWWW
