WWWWWWWWWWWWWWWWWWW
W..B...WW....W....W
W.W...........B...W
W...WW....WWW..WWWW
WWW.WWW...WWW....SW
WW..WWW.W.WW.....WW
WW.....B.B.......WW
WWW...W.W.W.......W
WWW..B.B.B........W
W....CW.W.WWWWWWWWW
W..B...B.B..W....BW
W...W..B.B..WLWDWBW
W.......W....B...BW
W..W....W.W..BBBBKW
WWWWWWWWWWWWWWWWWWW
