WWWWWWWWWWWWWWWWWWW
WDW..........WWWWWW
W.....WWW....IIIIWW
WWWW..WFW....WWWIWW
W............WWWIWW
W.W..........WIIIWW
W.WWW........WIWWWW
WLWS......T.YWIIIIW
W.WWW.....B..WWWWIW
W.W.B....W.W.WWWIIW
WB.BBW...W...WWWIWW
W.W.WW.T.W....WWIIW
W..B.W...W...BBKWIW
W....WWWWW..WWWWWQW
WWWWWWWWWWWWWWWWWWW
