WWWWW      WWWWW
W...WWWWWWWW...W
W.W.WW.T..WW.W.W
W..............W
WW.WWWW..WWWW.WW
 W.W W..P.W W.W
 WSW WC...W WDW
 WWW WWWWWW WWW
