WWWWWWWWWWWWWWWWWWW
WK................W
W...BBBBBBBB....B.W
W...............B.W
W......WWWWWW...B.W
W......WWSWWBBC.B.W
W......WW.WWBB....W
W.................W
W.................W
W......WWW....WWW.W
W.............L.W.W
W.WWW..WWW....WDW.W
W.WW.BB.......WWW.W
W.................W
WWWWWWWWWWWWWWWWWWW
