            WWW
    WWWWWWW WDW
    W.....W W.W
WWWWW.WWW.WWW.W
WS....W W.....W
WWWWWWW WWWWWWW
