WWWWWWWWWWWWWWWWWWW
WWK..............CW
WF.............P..W
WWWWW...B.........W
WWWWW.WTB.......W.W
WWWS..W.B.........W
WWWWWWW........W..W
WWWD..W........W..W
WWWWWLW...........W
WWWWWBB...W.....W.W
W...B.....W.....Y.W
W.WWB.W...........W
W.WWBB..........W.W
W...B.WW..WW..W...W
WWWWWWWWWWWWWWWWWWW
