       WWWW WWW
  WWWWWW..WWW.W
  W..W...B..BBW
  W.......WW..W
 WW.WWW.......WW
 W.BWFWWWWWBBB.W
 WW.W......B..WW
  W.W.WW.C.BBBW
WWW.W.W......BW
WKW.WYW....BBBW
WBW.W.WWWWWB.WWWWW
WBW.B.WD.L.BWW.S.W
WBWWBWWWWWW...B..W
WBBBBW    WWWWWWWW
WWWWWW
